5 5
0 0 3 2 1
0 0 1 5 2
0 0 4 3 1
1 0 2 2 1
2 1 0 1 1