7 7
0 0 0 0 0 3 2
0 0 0 0 0 1 2
0 0 10 0 0 3 1
0 0 0 0 0 2 2
0 0 0 0 0 1 0
1 0 0 0 0 1 0
2 3 0 2 0 1 0